☼☼☼☼☼☼☼☼☼☼☼☼☼☼☼☼☼☼☼☼☼☼☼☼☼☼☼☼☼☼☼☼☼☼☼☼☼☼☼☼☼☼☼☼☼☼☼☼☼☼☼☼☼☼☼☼☼☼☼☼
☼       ҉҉҉                                                ☼
☼         ☼☼☼☼☼    ☼☼☼☼☼      ☼☼☼☼     ☼       ☼##         ☼
☼ &       ☼        ☼    ☼##  ☼    ☼##  ☼☼     ☼☼           ☼
☼  #####  ☼        ☼    ☼    ☼  # ☼    ☼ ☼   ☼ ☼           ☼
☼         ☼     ## ☼    ☼    ☼    ☼   &☼  ☼ ☼  ☼      &    ☼
☼         ☼☼☼☼☼    ☼    ☼    ☼    ☼    ☼   ☼   ☼           ☼
☼         ☼        ☼☼☼☼      ☼☼ ☼☼☼    ☼       ☼           ☼
☼         ☼  ##    ☼     &   ☼    ☼##  ☼       ☼           ☼
☼         ☼    ##  ☼         ☼    ☼    ☼       ☼           ☼
☼     &   ☼☼☼☼☼    ☼####     ☼    ☼    ☼       ☼##     &   ☼
☼                                                          ☼
☼          &                                               ☼
☼   ☼☼☼☼  ☼     ☼   ☼☼☼☼   ☼☼☼☼☼  ☼☼☼☼☼  ☼       ☼   ☼☼☼☼  ☼
☼  ☼       ☼   ☼   ☼  &      ☼    ☼      ☼☼     ☼☼  ☼      ☼
☼  ☼  ##    ☼ ☼    ☼         ☼    ☼      ☼ ☼   ☼ ☼  ☼  &   ☼
☼  ☼    ###  ☼     ☼         ☼    ☼      ☼  ☼ ☼  ☼  ☼      ☼
☼   ☼☼☼☼   & ☼      ☼☼☼☼     ☼    ☼☼☼☼☼  ☼   ☼   ☼   ☼☼☼☼  ☼
☼       ☼    ☼          ☼    ☼    ☼      ☼       ☼       ☼ ☼
☼       ☼    ☼          ☼    ☼    ☼      ☼       ☼       ☼ ☼
☼       ☼    ☼          ☼    ☼    ☼      ☼       ☼       ☼ ☼
☼   ☼☼☼☼     ☼      ☼☼☼☼     ☼    ☼☼☼☼☼  ☼       ☼   ☼☼☼☼  ☼
☼                 #########            &                   ☼
☼           &           &                        &         ☼
☼      # # # #        &                                    ☼
☼  &                                                  &    ☼
☼         # # # #          ###########    #                ☼
☼                                                          ☼
☼    ☼☼☼☼☼  ☼☼☼☼☼☼☼☼☼☼☼☼☼☼☼☼☼☼☼☼☼☼☼☼☼☼☼☼☼☼☼☼☼ ☼☼☼☼☼☼☼☼☼☼☼  ☼
☼           ☼                     ☼   ☼     ☼ ☼            ☼
☼           ☼       # # # #                ☼  ☼            ☼
☼           ☼                     ☼&      ☼   ☼       &    ☼
☼     #     ☼  &&&                ☼      ☼                 ☼
☼           ☼         &           ☼                        ☼
☼        ###☼#########            ☼      ☼                 ☼
☼           ☼                     ☼       ☼                ☼
☼           ☼         &        # #☼# #     ☼               ☼
☼           ☼                     ☼         ☼☼☼☼☼☼☼☼☼☼☼☼☼#☼☼
☼           ☼☼☼☼☼☼☼☼☼☼☼☼☼☼☼☼☼ ☼☼☼☼☼                        ☼
☼           ☼            # #☼#        #  # # # # ### # #   ☼
☼     # # # ☼               ☼☼☼☼☼☼☼                        ☼
☼           ☼         &                                    ☼
☼           ☼          ####           # # # # # # #        ☼
☼   ☼☼☼☼☼☼☼☼☼                      &                       ☼
☼           ☼                                              ☼
☼          #☼# # #          ###########################    ☼
☼           ☼         &                &                   ☼
☼           ☼                                              ☼
☼   &       ☼      #  #  # # #             &               ☼
☼           ☼         &                                &   ☼
☼           ☼                                              ☼
☼                     &         #############              ☼
☼                     &                                    ☼
☼                                                          ☼
☼               ########                                   ☼
☼                 # # # #                                  ☼
☼                                                          ☼
☼                        # # # #                           ☼
☼                                                          ☼
☼☼☼☼☼☼☼☼☼☼☼☼☼☼☼☼☼☼☼☼☼☼☼☼☼☼☼☼☼☼☼☼☼☼☼☼☼☼☼☼☼☼☼☼☼☼☼☼☼☼☼☼☼☼☼☼☼☼☼☼
