☼☼☼☼☼☼☼☼☼☼☼☼☼☼☼☼☼☼☼☼☼☼☼☼☼☼☼☼☼☼☼☼☼☼☼☼☼☼☼☼☼☼☼☼☼☼☼☼☼☼☼☼☼☼☼☼☼☼
☼    $     $   &  »   ҉  $    ~~~~~~~~~     $     ~~~~~~~☼
☼##H########################H#H $     H##########H       ☼
☼  H$         $  & $        H######H  H     $    H#☼☼☼☼☼#☼
☼H☼☼#☼☼H    H#########H $   H#     H#####H#####H##  ~~~~~☼
☼H $   H    H         H#####H#  $  H ~   H $   H  ~~     ☼
☼H#☼#☼#H    H         H  ~~~ #####H#     H     H    ~~   ☼
☼H $~$ H~~~~H~~~~~~   H  $        H   H######H##      ~~$☼
☼H $ $ H    H  $  H###☼☼☼☼☼☼H☼    H~~~H      H          #☼
☼H     H $  H#####H         H     H      H#########H     ☼
☼☼###☼##☼##☼H   & $   H###H## $  H##     H#   $   ## $   ☼
☼☼###☼~~~~  H         H   H######H######### H###H #####H#☼
☼☼$$$☼ »    H   ~~~~~~H   H $    H          H#$#H   $  H ☼
☼########H###☼☼☼☼     H  ############ $ ###### ##########☼
☼   $    H     $   $  H        $             $       $   ☼
☼H##########################H########~~~####H############☼
☼H   $      $      ~~~     ҉H               H    $       ☼
☼#######H#######            H###~~~~      ############H  ☼
☼       H~~~~~~~~~~     $   H    $»             $     H  ☼
☼       H    ##H   #######H##########~~~~~~~H######## H  ☼
☼       H    ##H  $       H                 H   $$$$  H $☼
☼##H#####    ########H#######~~~~  ~~~#########~~~~~  H  ☼
☼  H  $      $   &   H            $               ~~~~H  ☼
☼#########H##########H        #☼☼☼☼☼☼#   ☼☼☼☼☼☼☼      H $☼
☼         H   &      H        ~      ~   $    $       H  ☼
☼☼☼     $ H~~~~~~~~~~H   $ ҉   ######   ###########   H  ☼
☼    H######         #######H     $     ~~~~~~~~~~~~~~H  ☼
☼H☼  H  ◄     ҉  $          H ҉H####H        $    $   H $☼
☼H☼☼#☼☼☼☼☼☼☼☼☼☼☼☼###☼☼☼☼☼☼☼☼H☼☼☼☼☼☼☼☼#☼☼☼☼☼☼☼☼☼☼☼☼☼☼☼☼☼☼#☼
☼H    &  $    ~~H~~~~☼☼☼☼☼☼☼H☼☼☼☼☼☼☼    $  H   ~~~~~~~~~H☼
☼H~~~~  ######  H    $    H☼H☼H҉$      ####H  ☼  $$$    H☼
☼H $    $       ##H#######H☼H☼H######H     ###☼☼☼☼☼☼☼☼ ~H☼
☼H#########     $ H    ~~~H☼H☼H~~~$  H~~~~~ ##  $$$   ~ H☼
☼H        ###H####H##H     ☼H☼       H     ###☼☼☼☼☼☼ ~  H☼
☼H    &      H 1    #######☼H☼#####  H#####   ~~~~~~~ ~ H☼
☼~~~~~~~~~~~~H       H~~~~~☼H☼~~~~~  H    $        ~ ~  H☼
☼     H    »  $      H  $  ☼H☼     ##########H    $     H☼
☼ ### #############H H#####☼H☼    $          H ######## H☼
☼H           ҉     H       ☼H☼#######   $    H   $      H☼
☼H#####    $    H##H#### $  ҉ $         ###H#########   H☼
☼H      H######### H   ############        H    $       H☼
☼H##    H  $       H~~~~~~$  ҉  $          H #######H## H☼
☼~~~~#####H#   ~~~~H         ########H     H        H   H☼
☼     $   H    ҉   H  $   ~~~~~~~~   H  $  H        H   H☼
☼   ########H    ######H##    ҉   ##############    H$  H☼
☼$          H  $       H  $    $~~~~~           ##H#####H☼
☼H    ###########H ҉   H#####H ҉  $    H##H       H     H☼
☼H###            H     H     ###########  ##H###  H     H☼
☼H  ######  ##H######  H  $     ҉      $    H   ##H###  H☼
☼H     $      H ~~~~~##H###H »   #########H##           H☼
☼    H########H#       H   ######      $  H  $         $H☼
☼ ###H  $     H    $    ~~~~~H  ҉   ##H###H####H###     H☼
☼$   H########H#########     H        H        H        H☼
☼H   H      $     ҉       $  H      $ H        H  $    $H☼
☼H  ####H######    $    #####H########H##      H#####   H☼
☼H   $  H      H#######H       ҉ $  ҉     $    H     $  H☼
☼##############H   $   H#################################☼
☼☼☼☼☼☼☼☼☼☼☼☼☼☼☼☼☼☼☼☼☼☼☼☼☼☼☼☼☼☼☼☼☼☼☼☼☼☼☼☼☼☼☼☼☼☼☼☼☼☼☼☼☼☼☼☼☼☼