☼☼☼☼☼☼☼☼☼☼☼☼☼☼☼☼☼☼☼☼☼☼☼☼☼☼☼☼☼☼☼
☼ ☼҉☼                         ☼
☼ ☼ ☼#☼#☼#☼#☼#☼#☼#☼#☼#☼#☼#☼#☼#☼
☼         ######              ☼
☼ ☼ ☼#☼#☼#☼#☼#☼#☼#☼#☼#☼#☼#☼#☼#☼
☼    ######                   ☼
☼ ☼ ☼#☼#☼#☼#☼#☼#☼#☼#☼#☼#☼#☼#☼#☼
☼             ######          ☼
☼ ☼ ☼#☼#☼#☼#☼#☼#☼#☼#☼#☼#☼#☼#☼#☼
☼       ######                ☼
☼ ☼ ☼#☼#☼#☼#☼#☼#☼#☼#☼#☼#☼#☼#☼#☼
☼                             ☼
☼ ☼ ☼#☼#☼#☼#☼#☼#☼#☼#☼#☼#☼#☼#☼#☼
☼             #        #      ☼
☼ ☼ ☼#☼#☼#☼#☼#☼#☼#☼#☼#☼#☼#☼#☼#☼
☼     #####                   ☼
☼ ☼ ☼#☼#☼#☼#☼#☼#☼#☼#☼#☼#☼#☼#☼#☼
☼            #######          ☼
☼ ☼ ☼#☼#☼#☼#☼#☼#☼#☼#☼#☼#☼#☼#☼#☼
☼                             ☼
☼ ☼ ☼#☼#☼#☼#☼#☼#☼#☼#☼#☼#☼#☼#☼#☼
☼                             ☼
☼ ☼ ☼#☼#☼#☼#☼#☼#☼#☼#☼#☼#☼#☼#☼#☼
☼           #######           ☼
☼ ☼ ☼#☼#☼#☼#☼#☼#☼#☼#☼#☼#☼#☼#☼#☼
☼                             ☼
☼ ☼ ☼#☼#☼#☼#☼#☼#☼#☼#☼#☼#☼#☼#☼#☼
☼                             ☼
☼ ☼ ☼ ☼ ☼ ☼ ☼ ☼ ☼ ☼ ☼ ☼ ☼ ☼ ☼ ☼
☼     #########               ☼
☼☼☼☼☼☼☼☼☼☼☼☼☼☼☼☼☼☼☼☼☼☼☼☼☼☼☼☼☼☼☼
