☼☼☼☼☼☼☼☼☼☼
☼҉       ☼
☼####    ☼
☼   &    ☼
☼####    ☼
☼   &    ☼
☼####    ☼
☼   &    ☼
☼####    ☼
☼☼☼☼☼☼☼☼☼☼