##############
#1...O......2#
#......$O....#
#....####....#
#....#  #....#
#.O###  ###.O#
#.$#      #..#
#..#      #$.#
#O.###  ###O.#
#....#  #....#
#....####....#
#....O$......#
#4......O...3#
##############