-#######----#######-
##.....##--##.....##
#.1.....#--#.....2.#
#.......####.......#
#.....B............#
#.......B..B.......#
#.......B......B...#
##................##
-###.B...OO..BB.###-
---#....O$$O....#---
---#....O$$O....#---
-###.BB..OO...B.###-
##................##
#...B......B.......#
#.......B..B.......#
#............B.....#
#.......####.......#
#.4.....#--#.....3.#
##.....##--##.....##
-#######----#######-