--------------------
--------------------
---O-----OO--OOO----
---O----O--O-O--O---
---O----O--O-O--O---
---O----O--O-OOO----
---O----O--O-O--O---
---O----O--O-O--O---
---OOOO--OO--OOO----
--------------------
--------------------
---------OOO--O--O--
---------O--O-O--O--
----$----O--O-O--O--
---$O$---OOO---OOO--
----$----O--O----O--
---------O--O---O---
---------OOO--OO----
--------------------
--------------------