####################
#$......$..$......$#
#BBBBB........BBBBB#
#....BB......BB....#
#.1..B.B....B.B..2.#
#....BB.B..B.BB....#
#....B.BBBBBB.B....#
#....B.B....B.B....#
#..................#
#..................#
#..................#
#..................#
#....B.B....B.B....#
#....B.BBBBBB.B....#
#....BB.B..B.BB....#
#.4..B.B....B.B..3.#
#....BB......BB....#
#BBBBB........BBBBB#
#$......$..$......$#
####################