----------
-########-
-#1.O..O#-
-#....O.#-
-####O..#-
----#..O#-
-####.O.#-
-#E..O..#-
-########-
----------