--------
---###--
---#1#--
---#.#--
---#.#--
---#E#--
---###--
--------