----------
-########-
-#1.....#-
-#..###.#-
-#..#-#.#-
-#.$###.#-
-#......#-
-#..$..E#-
-########-
----------