`☼☼☼☼☼`````
`☼```☼☼☼☼``
`☼``````☼``
☼☼☼`**☼`☼``
☼``☼*`*☺☼``
☼```*`☼☼☼``
☼``☼☼``☼```
☼☼`````☼```
`☼X■☼``☼```
`☼``☼☼☼☼```
`☼☼☼☼``````