####################
#O$O$O$O$O$O$O$O$O$#
#$O.O.O.O.O.O.O.O.O#
#O.O.O.O.O.O.O.O.O$#
#$O.1.O.O.O.O.O.O.O#
#O.O.O.O.O.O.O.2.O$#
#$O.O.O.O.O.O.O.O.O#
#O.O.O.O.O.O.O.O.O$#
#$O.O.O.O.O.O.O.O.O#
#O.O.O.O.O.O.O.O.O$#
#$O.O.O.O.O.O.O.O.O#
#O.O.O.O.O.O.O.O.O$#
#$O.O.O.O.O.O.O.O.O#
#O.O.O.O.O.O.O.O.O$#
#$O.4.O.O.O.O.O.O.O#
#O.O.O.O.O.O.O.3.O$#
#$O.O.O.O.O.O.O.O.O#
#O.O.O.O.O.O.O.O.O$#
#$O$O$O$O$O$O$O$O$O#
####################