-------######-------
-----###....###-----
---###........###---
--##............##--
--#......B.......#--
-##......B.......##-
-#.......B...2....#-
##...1...BB.......##
#.......$OB$.......#
#......BBOOOBBBB...#
#...BBBBOOOBB......#
#.......$BO$.......#
##.......BB...3...##
-#....4...B.......#-
-##.......B......##-
--#.......B......#--
--##............##--
---###........###---
-----###....###-----
-------######-------