--------------------
--------------------
-$------OO---EEE----
-$-----O--O--E--E---
-$-----O--O--E--E---
-$-----O--O--EEE----
-$-----O--O--E--E---
-$-----O--O--E--E---
-$$$$---OO---EEE----
--------------------
--------------------
---------BBB---.--.-
---------B--B---.-.-
----$----B--B---.-.-
---$O$---BBB-----.--
----$----B--B----.--
---------B--B---.---
---------BBB----.---
--------------------
--------------------