####################
#..................#
#..................#
#..................#
#..#....###..###...#
#..#....#.#..#.#...#
#..#....#.#..###...#
#..#....#.#..#.#...#
#..###..###..###...#
#..................#
#..................#
#........###..#.#..#
#........#.#..#.#..#
#........###...#...#
#........#.#...#...#
#........###...#...#
#..................#
#..................#
#..................#
####################