--------
-######-
-#1...#-
-####.#-
----#.#-
----#E#-
----###-
--------