--------------
--------------
-############-
-#..........#-
-#.########.#-
-#.#------#.#-
-#.#-####-#.#-
-#.#-#.1#-#.#-
-#.#-#.##-#.#-
-#.#-#.#--#.#-
-#.#-#.####.#-
-#E#-#......#-
-###-########-
--------------