---------------
---------------
--########-----
--#1...B.#-----
--###B...#-----
----#B..B#-----
--###$B..####--
--#$....B..B#--
--#.#####B..#--
--#.#---#...#--
--#.#####.B.#--
--#.E.....B$#--
--###########--
---------------
---------------