########----########
##$....##--##....$##
#$......####......$#
#..1.....##.....2..#
#.....B......B.....#
#....B..B..B..B....#
#...B..........B...#
##.....BB..BB.....##
-##..B.B####B.B..##-
--##....#--#....##--
--##....#--#....##--
-##..B.B####B.B..##-
##.....BB..BB.....##
#...B..........B...#
#....B..B..B..B....#
#.....B......B.....#
#..4.....##.....3..#
#$......####......$#
##$....##--##....$##
########----########