☼☼☼☼☼☼☼☼☼☼☼☼☼☼☼☼☼☼☼☼☼☼☼☼☼☼☼☼☼☼
☼          $                 ☼
☼                            ☼
☼   $              $         ☼
☼                       $    ☼
☼  $                         ☼
☼                            ☼
☼                            ☼
☼              $             ☼
☼        $                   ☼
☼                            ☼
☼                            ☼
☼ $                         $☼
☼                            ☼
☼              $             ☼
☼                            ☼
☼    $                       ☼
☼                            ☼
☼                       $    ☼
☼                            ☼
☼                            ☼
☼                            ☼
☼            $               ☼
☼                            ☼
☼                            ☼
☼       $                $   ☼
☼                            ☼
☼       ☺        $           ☼
☼                            ☼
☼☼☼☼☼☼☼☼☼☼☼☼☼☼☼☼☼☼☼☼☼☼☼☼☼☼☼☼☼☼