"☼☼☼☼☼☼☼☼☼☼☼☼☼☼☼☼☼☼☼☼☼☼☼☼☼☼☼☼☼☼" +
                "☼          $                 ☼" +
                "☼                            ☼" +
                "☼   $              $         ☼" +
                "☼                       $    ☼" +
                "☼  $                         ☼" +
                "☼                            ☼" +
                "☼                            ☼" +
                "☼              $             ☼" +
                "☼        $                   ☼" +
                "☼                            ☼" +
                "☼                            ☼" +
                "☼ $                         $☼" +
                "☼                            ☼" +
                "☼              $             ☼" +
                "☼                            ☼" +
                "☼    $                       ☼" +
                "☼                            ☼" +
                "☼                       $    ☼" +
                "☼                            ☼" +
                "☼                            ☼" +
                "☼                            ☼" +
                "☼            $               ☼" +
                "☼                            ☼" +
                "☼                            ☼" +
                "☼       $                $   ☼" +
                "☼                            ☼" +
                "☼       ☺        $           ☼" +
                "☼                            ☼" +
                "☼☼☼☼☼☼☼☼☼☼☼☼☼☼☼☼☼☼☼☼☼☼☼☼☼☼☼☼☼☼";